强化学习	強化學習
随机森林	隨機森林
进化计算	進化計算
人工智慧
半监督学习	半監督學習
机器视觉	機器視覺
等距特征映射	等距特徵映射
玻尔兹曼机	玻爾茲曼機
提升方法
前馈神经网络	前饋神經網絡
认知神经科学	認知神經科學
词嵌入	詞嵌入
波茨曼机	波茨曼機
表征学习	錶徵學習
Word2vec
计算机模式识别	計算機模式識彆
Hopfield神经网络	Hopfield神經網絡
有监督分类	有監督分類
信息抽取
深度强化学习	深度強化學習
径向基函数网络	徑嚮基函數網絡
文档分类	文檔分類
前馈网络	前饋網絡
知识工程	知識工程
一次性学习	一次性學習
定量构效关系	定量構效關係
支持向量机	支持嚮量機
生成对抗网络	生成對抗網絡
自然语言处理	自然語言處理
人工智能
知识表现	知識錶現
协同神经网络	協同神經網絡
机器翻译	機器翻譯
稀松字典学习	稀鬆字典學習
多层感知器	多層感知器
长短期记忆人工神经网络	長短期記憶人工神經網絡
对抗机器学习	對抗機器學習
非线性降维	非綫性降維
霍普菲尔德网络	霍普菲爾德網絡
循环网络	循環網絡
线上机器学习	綫上機器學習
生成式对抗网络	生成式對抗網絡
霍普菲尔德神经网络	霍普菲爾德神經網絡
信息系统	信息係統
知识表示	知識錶示
智械
分类	分類
自动驾驶	自動駕駛
深层学习	深層學習
机器学习	機器學習
语音辨识	語音辨識
主动学习	主動學習
群体决策支持系统	群體決策支持係統
化学计量学	化學計量學
诊断	診斷
面容识别	麵容識彆
深度学习	深度學習
回归网络	迴歸網絡
进化算法	進化算法
非监督式学习	非監督式學習
临床决策支持系统	臨床決策支持係統
图型识别	圖型識彆
迁移学习	遷移學習
决策树学习	決策樹學習
词性标记	詞性標記
元启发算法	元啓發算法
阶层时间记忆	階層時間記憶
面像识别	麵像識彆
反向传播	反嚮傳播
卷积神经网络	捲積神經網絡
无监督分类	無監督分類
知识表达	知識錶達
感知元
递归网络	遞歸網絡
多层感知机	多層感知機
类神经网路	類神經網路
局部搜索
机器智慧	機器智慧
认知学	認知學
递归神经网络	遞歸神經網絡
基因演算法
语音输入	語音輸入
样式辨认	樣式辨認
监督式学习	監督式學習
AI
自然语言理解	自然語言理解
神经网络	神經網絡
人脸识别	人臉識彆
感知器
人工神经网络	人工神經網絡
启发式演算法	啓發式演算法
广义形态分析法	廣義形態分析法
零次学习	零次學習
遗传算法	遺傳算法
模式识别	模式識彆
自编码	自編碼
图模型	圖模型
面部识别	麵部識彆
人工智慧网路	人工智慧網路
计算机视觉	計算機視覺
知识重呈	知識重呈
循环神经网络	循環神經網絡
强人工智慧	強人工智慧
专家系统	專傢係統
优化问题	優化問題
无监督学习	無監督學習
反馈网络	反饋網絡
启发式搜索	啓發式搜索
人机交互	人機交互
无人驾驶	無人駕駛
认知科学	認知科學
GOFAI
监督学习	監督學習
回馈网络	迴饋網絡
语音识别	語音識彆
奖励学习	奬勵學習
独立成分分析	獨立成分分析
认知科学家	認知科學傢
认知人类学	認知人類學
语音合成	語音閤成
感知机	感知機
自主导航	自主導航
Seq2Seq模型
