A轮	A輪
B轮	B輪
C轮	C輪
D轮	D輪
上市
中资	中資
云	雲
交易
产品	産品
人民币	人民幣
今天宣布
併購
入股
兼併
兼并	兼並
出局	齣局
创	創
创始人	創始人
创投	創投
创投圈	創投圈
创新	創新
发展	發展
发行	發行
合作	閤作
合併	閤併
合并	閤並
吸金
基金
增资	增資
增长	增長
外企
大增
天使
定增外
实现	實現
宣布
局限性
已经吸引	已經吸引
已经集资	已經集資
市场	市場
布局
并购	並購
战略	戰略
投
投入
投圈
投标	投標
投資
投资	投資
投资方	投資方
投资者包括	投資者包括
投资轮次	投資輪次
报收	報收
披露
控股
推手
提供
支付
收入
收購
收购	收購
放宽	放寬
数据	數據
新的一轮	新的一輪
方案
智能
服务	服務
本轮	本輪
欧元	歐元
百万轮次	百萬輪次
种子基金	種子基金
种子轮	種子輪
美元
美金
股东	股東
股份
股权	股權
获	獲
获得	獲得
融资	融資
融资轮次	融資輪次
行业	行業
解决	解決
财力	財力
费率	費率
资产	資産
资本	資本
资金	資金
赔付	賠付
跟投
转让	轉讓
轮	輪
轮领	輪領
降温	降溫
集团	集團
领	領
领投	領投
风险投资	風險投資
高价值	高價值
